adminmenu/shared.lua	adminmenu
afkchanged.lua	afkchanged
afkkickhelper.lua	afkkickhelper
arclight/arclight.lua	arclight
audit.lua	audit
autoexec/shared.lua	autoexec
autospec/shared.lua	autospec
balance/balance.lua	balance
betterknownas.lua	betterknownas
bots.lua	bots
broadcast.lua	broadcast
captains/captains.lua	captains
chatchannels.lua	chatchannels
communityslots.lua	communityslots
crashreconnect/shared.lua	crashreconnect
damagemodifier.lua	damagemodifier
disablestockmapvote.lua	disablestockmapvote
emptymapcycler.lua	emptymapcycler
enforceteamsizes.lua	enforceteamsizes
everysecond/shared.lua	everysecond
forceroundstart.lua	forceroundstart
friendlyfiretweaks.lua	friendlyfiretweaks
fullgameplayed.lua	fullgameplayed
gamestartevents.lua	gamestartevents
gamestracker.lua	gamestracker
gorgetunnelhelper/shared.lua	gorgetunnelhelper
greetings.lua	greetings
groundedrookies.lua	groundedrookies
help.lua	help
hidefullmodlist.lua	hidefullmodlist
hidespectators.lua	hidespectators
improvedafkhandler.lua	improvedafkhandler
infestedhelper/shared.lua	infestedhelper
karma.lua	karma
lapstracker.lua	lapstracker
lookdown.lua	lookdown
mapvotehelper.lua	mapvotehelper
modupdatednotice.lua	modupdatednotice
movement/movement.lua	movement
newcomms/shared.lua	newcomms
noattackpregame.lua	noattackpregame
notifyadminonmuteplayer.lua	notifyadminonmuteplayer
perficon/shared.lua	perficon
permissions.lua	permissions
playerlocationchanged.lua	playerlocationchanged
pregamescoreboardsort/shared.lua	pregamescoreboardsort
primeablechat/primeablechat.lua	primeablechat
printablenames.lua	printablenames
prohibitednames.lua	prohibitednames
push.lua	push
recordinghelper/shared.lua	recordinghelper
reluse.lua	reluse
restartwhenempty/shared.lua	restartwhenempty
rookiethrottle.lua	rookiethrottle
rotatingeggspawns/shared.lua	rotatingeggspawns
scoreboardicons.lua	scoreboardicons
scoreboard/shared.lua	scoreboard
serverstart/shared.lua	serverstart
sidebar.lua	sidebar
siegehelper.lua	siegehelper
spawnselectionoverrides.lua	spawnselectionoverrides
specbets.lua	specbets
speclimit.lua	speclimit
speclisten.lua	speclisten
sprayhelper/shared.lua	sprayhelper
squadnumbers/shared.lua	squadnumbers
stagedteamjoins.lua	stagedteamjoins
statusextended.lua	statusextended
taglines.lua	taglines
targetedcommands.lua	targetedcommands
td/td.lua	td
teamres.lua	teamres
teamroles.lua	teamroles
teamswitch.lua	teamswitch
teamticker.lua	teamticker
tempgroups.lua	tempgroups
tgnsbadges/shared.lua	tgnsbadges
timedstart.lua	timedstart
updatetoreadyroomhelper.lua	updatetoreadyroomhelper
uweranking.lua	uweranking
voicecommreminder.lua	voicecommreminder
winorlose.lua	winorlose
wraplength/shared.lua	wraplength
